00000000000000000000000000000000000000000000000000000000000000000000000000000000000000000000000000000000000000000000000000000000000000000000000000000000000000000000000
000000000000000000000000000000000000000000E000000000000000000000000P000000000000000000000000000000000000000000000000000000000000000000000000000000000000000000000000000
000000000000000000000000000000000ABC00000ABC000000000000000000000000000000000000000000000000000000000000000000000000000000000000000000000000000000000000000000000000000
0000000000000000000000000000E000000000000000000000000000000000000000000000000000000000000000000000000000000000000ABC000000000000000000000000000000000000000000000000000
000000000000000000000000000ABC0000000000000000000ABC0000000000000000000000000000000000000000000000000000000000000000000000000000000000000000000000000000000000000000000
000000000000000000000000000000000000000000000000000000000000000000ABC00000000000000000000000000000000000000000000000000000000000000000000000000000000000000000000000000
0000000000000000000000000000000000000000000000000000000000001300000000000000001300000000000000000000000ABC0000000000000000000000000000000000000000000000000000000000000
000000000000000000000000000000000000000000000000000000000001W600000000000000004Q3000000000000000000000000000000000000000000EEEEEEEEE000EE0000EE00000EE00000000000000000
000000000000000000000000000000000ABC00000000000000000000001W56000000000000000045Q30000000000000000000000000000000000000000000000000000000000000000000000000000000000000
0000000000000000000000000000000000000000000000000000000001W5560000000000000000455Q300000000000000000000000000000ABC0000000000000000000000000000000000000000000000000000
0000000000000E0000130000000000000000E00000000000000E00001W555600000000000000004555Q3000000000000000000000000000000000000000000000000000000000000000000000000000S0000000
222222222222222222WQ222222300012222222222300000000122222W555560000000000000000455556000000ABC000000000ABC0000000000000000000000000000000000000000000000LLLLLLLLLLLLLLLL
5555555555555555555555555560004555555555560000000045555555555600000000000000004555560000000000000000000000000000000000000000000000000000000000000000000LLLLLLLLLLLLLLLL